"risus"	"Document 3"
"scelerisque"	"Document 3"
"sit"	"Document 1, Document 3"
"tortor"	"Document 2"
"consectetur"	"Document 1"
"dolor"	"Document 1"
"Donec"	"Document 2"
"Lorem"	"Document 1"
"Nulla"	"Document 3"
"ac"	"Document 3"
"adipiscing"	"Document 1"
"amet"	"Document 3"
"amet,"	"Document 1"
"condimentum"	"Document 2"
"varius,"	"Document 2, Document 3"
"vel"	"Document 2"
"laoreet"	"Document 2"
"luctus"	"Document 3"
"mattis."	"Document 3"
"Document"	"Document 1, Document 2, Document 3"
"elit"	"Document 2, Document 3"
"elit."	"Document 1"
"felis"	"Document 3"
"id"	"Document 2"
"ipsum"	"Document 1"
"1:"	"Document 1"
"2:"	"Document 2"
"3:"	"Document 3"
"mauris"	"Document 2"
"placerat."	"Document 2"
